6
8
######
#...m#
#..#.#
#.##.#
#m#..#
#....#
#.l#t#
######
left
right
up
down,white
