12
9
############
##.w..#t##t#
##..l.#..#.#
#t....-.c.w#
##.cc.#.#..#
#t....-m.w.#
##.l..#.#..#
##..w.#t##t#
############
up
up,red
up,white
down
left,white
white
right
red
blue
left,red
right
right
up
down
down,blue
down,white
