9
9
#########
####..###
#t...w.t#
##.....##
#t.w...t#
##...c.##
##.c.l.##
###l.####
#########
left,red
up
right,white
left,red
up
right,white
red
white
up
up
