9
10
#########
##..w.c##
##.m...##
##...w.##
##m.m..##
##-----##
##.....##
##...l.##
##t#t#t##
#########
left
blue
right
up
left
left
up
down,blue
down,white
down,blue
