13
12
#############
####.m.m.m.t#
####l......##
#tw-..m.m..##
##-#.#-#...##
##...-c-...##
##...#-#.#-##
##.......-wt#
####-#...####
####w-...####
####t########
#############
left
left
left
right,green
right
left,white
up
right
right
green
down
right,white
left
down,green
