16
9
################
#######t########
####....l..t####
####mmm.w..#####
#t-.........-cl#
####..w.mmm#####
###t.......#####
#######t########
################
up,white
down
right,white
right
left
right
down
left,green
green
left
down
right
left
right
left,white
down,white
