24
15
########################
#......................#
#......................#
#..1................3..#
#.........####.........#
#.........####.........#
######....####....######
######....####....######
######....####....######
#.........####.........#
#.........####.........#
#..4................2..#
#......................#
#......................#
########################
