10
7
##########
#####..###
##....l.t#
###.##..##
#t.l...###
###..#####
##########
left
right,white
left,white
right
