11
9
###########
###..#.m###
#t...-...##
##.m.#..w##
#t...-...##
##w..#..l##
##...-...t#
###m.#..###
###########
left
left,white
left
down
left,white
up
left
right,white
left
