14
9
##############
######t#######
####m.l-w.t###
####.m.-.m####
#t-.......-cl#
###m.-.m.#####
##t.w-w.m#####
######t#######
##############
up,white
right
down
down
right,white
left
right
left,green
green
left
right
left
left,white
up
down
right
down,white
