15
15
###############
#####.....#####
###....1....###
##...........##
##...........##
#.............#
#.............#
#.4.........3.#
#.............#
#.............#
##...........##
##...........##
###....2....###
#####.....#####
###############
